1111111111111111111
1000001000000001001
100B001000000000001
10000000B0011110B01
10P00000000100E0001
1111111111111111111