1111111111111111111
1000001000000001001
1000001000000000001
1000000000011110001
10P00000000100E0001
1111111111111111111