1111111111111111111
10000010000C0001001
100B001000000000001
10000000B0011110B01
10P000C000010000001
1111111111111111111