1111111111111111111
10000010000C0001001
1000001000000000001
1000000000011110001
10P000C000010000001
1111111111111111111