111111111111111110
10000010000C000100
100000100000000000
100000000001111000
10P000C00001E00001
111111111111111111