 11111111111111111
 10000010000C00011
 10000010000000001
1000000000011110001
10P000C0000100E0001
1111111111111111111