111111111111111111111111111111
10P0001000000001000000C0000001
10000010000#00111000000#000001
110C01110C00000100000000100001
100000000000000000#00000100001
100111000011110C00001111111111
1001000#0000100000#0000000E001
111111111111111111111111111111